# A part-of-speech dictionary that's used additionally to the binary dictionary (*.dict).
# This does not add words to the spell checker, see hunspell/spelling.txt for that.
# File Encoding: UTF-8
# Format: three tab-separated fields: fullform baseform postags
bellcrank	bellcrank	NN
bellcranks	bellcrank	NNS
bloggers	blogger	NNS
Bluetooth	Bluetooth	NNP
boomset	boomset	NN
boomsets	boomset	NNS
callouts	callout	NNS
cancellable	cancellable	JJ
Coon	Coon	NNP
download	download	NN
downloads	download	NNS
Doxygen	Doxygen	NNP
droopily	droopily	RB
Drupal	Drupal	NNP
Facebook	Facebook	NNP
Firefox	Firefox	NNP
glitchier	glitchy	JJR
glitchiest	glitchy	JJS
glitchy	glitchy	JJ
Google	Google	NNP
grayscale	grayscale	JJ
hashtag	hashtag	NN
hashtags	hashtag	NNS
hyperlink	hyperlink	NN
hyperlinks	hyperlink	NNS
iBook	iBook	NNP
iBooks	iBooks	NNP
interlay	interlay	NN
interlays	interlay	NNS
Javadoc	Javadoc	NNP
JavaHelp	JavaHelp	NNP
jQuery	jQuery	NNP
LexisNexis	LexisNexis	NNP
LibreOffice	LibreOffice	NNP
LinkedIn	LinkedIn	NNP
Microsoft	Microsoft	NNP
miserly	miserly	JJ
misrigged	misrigged	JJ
muchly	muchly	RB
Multimap	Multimap	NNP
multipart	multipart	JJ
naff	naff	JJ
naffer	naff	JJR
naffest	naff	JJS
naïve	naïve	JJ
oilfree	oilfree	JJ
passphrase	passphrase	NN
passphrases	passphrase	NNS
PayPal	PayPal	NNP
pitot	pitot	NN
pitots	pitot	NNS
potlife	potlife	NN
potlives	potlife	NNS
prearrival	prearrival	JJ
preowned	preowned	JJ
retractive	retractive	JJ
retractive	retractive	NN
retractives	retractive	NNS
revolutionary	revolutionary	JJ
screencast	screencast	NN
screencasts	screencast	NNS
screwjack	screwjack	NN
screwjacks	screwjack	NNS
sealant	sealant	NN:UN
servicing	servicing	NN:U
Skype	Skype	NNP
slantways	slantways	RB
smartphone	smartphone	NN
smartphones	smartphone	NNS
spanwise	spanwise	RB
species	species	NNS
speedbrake	speedbrake	NN
speedbrakes	speedbrake	NNS
splined	splined	JJ
subfolder	subfolder	NN
subfolders	subfolder	NNS
subtextual	subtextual	JJ
supermicron	supermicron	JJ
Symbian	Symbian	NNP
taskbars	taskbar	NNS
termbase	termbase	NN
termbases	termbase	NNS
thereunto	thereunto	RB
think	think	NN
tooltip	tooltip	NN
tooltips	tooltip	NNS
touchpoint	touchpoint	NN
touchpoints	touchpoint	NNS
unencrypted	unencrypted	JJ
unforthcoming	unforthcoming	JJ
unimolecular	unimolecular	JJ
uninsulated	uninsulated	JJ
unlinked	unlinked	JJ
upset	upset	JJ
viewport	viewport	NN
viewports	viewport	NNS
walkthrough	walkthrough	NN
walkthroughs	walkthrough	NNS
webcast	webcast	NN
webcasts	webcast	NNS
webinar	webinar	NN
webinars	webinar	NNS
wiki	wiki	NN
Wikipedia	Wikipedia	NNP
wikis	wiki	NNS
WordPress	WordPress	NNP
worksite	worksite	NN
worksites	worksite	NNS
XMetaL	XMetaL	NNP
XMLmind	XMLmind	NNP
YouTube	YouTube	NNP
